331333133331111111-
131313131131111111-
131313131131111111-
131313131131111111-
131313131131111111-
131313131131111111-
133313331133111111-
111111111111111111
